11111122222222222222222222222222222222222222111111
11111100000000000000000000000000000000000000111111
11111100000000000000000000000000000000000000111111
11111100000000000000000000000000000000000000111111
11111100000000000000000000000000000000000000111111
11111100000000000000000000000000000000000000111111
11111100000022000000000000000000000002220000111111
11111100000000000000000000000000000000000000111111
11111100000000000000000000000000000003000000111111
11111100000022220000000000000000000022222200111111
11111100000000000000400000000000000000000000111111
11111100030000000022222000000222220000000000111111
11111102222000000000000000000000000000000000111111
11111100000000000000000000000000000000000000111111
11111100000002222200000000000000000022222200111111
11111100000000000000000222222000030000000000111111
11111100000000000000000000000002222000000000111111
11111100000000000000000000000000000000000000111111
11111100000000000000000040000000000000000000111111
11111122222222222222222222222222222222222222111111
11111111111111111111111111111111111111111111111111
11111111111111111111111111111111111111111111111111