11111122222222222222222222222222222222222222111111
11111100000000000000000000000000000000000000111111
11111100000000000000000000000000000000000000111111
11111100000000000000000000000000000000000000111111
11111100000000000000000000000000000000000000111111
11111100000000000000000000000000000000000000111111
11111100000000030000000000000000000000030000111111
11111100000022220000000000000000000022222200111111
11111100000000000000000000000000000000000000111111
11111100000000000022222000000222220000000000111111
11111100000000000000000000000000000000000000111111
11111100000000300000000000000000000000300000111111
11111100000002222000000000000000000002220000111111
11111100030000000000000000000000000000000000111111
11111100000000000000000000000000000004000000111111
11111100000022220000000000000000000022222200111111
11111100000000000000000000000000000000000000111111
11111100030000000022222000000222220000000000111111
11111100222200000000000000000000000000000000111111
11111100000000000000000000000000000000300000111111
11111100000002222200000004000000000022222200111111
11111100000000000000000222222000000000000000111111
11111100000000000000000000000000030000000000111111
11111100000000000000000000000000222200000000111111
11111100000000000000000000000000000000000000111111
11111122222222222222222222222222222222222222111111
11111111111111111111111111111111111111111111111111
11111111111111111111111111111111111111111111111111

