11111122222222222222222222222222222222222222111111
11111100000000000000000000000000000000000000111111
11111100000000000000000000000000000000000000111111
11111100000000000000000000000000000000000000111111
11111100000000000000000000000000000000000000111111
11111100000000220000000000000000000000222000111111
11111100000000000000000000000000000000000000111111
11111100000000000000000000000000000000000000111111
11111100000022220000000000000000000022222000111111
11111100000000000000000000000000000000000000111111
11111100000000000022222000000222220000000000111111
11111102222000000000000000000000000000000000111111
11111100000000030000000000000000000000000000111111
11111100000002222200000000000000000022222200111111
11111100000000000000000022222200000000000000111111
11111100000000000000000000000000000000000000111111
11111100000000000000000000000000000000000000111111
11111122222222222222222222222222222222222222111111
11111111111111111111111111111111111111111111111111
11111111111111111111111111111111111111111111111111

