11111122222222222222222222222222222222222222111111
11111100000000000000000000000000000000000000111111
11111100000000000000000000030000000000000000111111
11111100000000000000000000222220000000000000111111
11111100000000030000000000000000000000000000111111
11111100000002222000000000000000000000222000111111
11111100000000000000000000000000000000000000111111
11111100000000000000000000000000000040030000111111
11111100000002222000000000000000000222222000111111
11111100000000002000400000000030000000000000111111
11111100000000002222222000002222200000000000111111
11111122222000000000000000000000000000000000111111
11111100000000030000000000000000000000400000111111
11111100000002222220000004000000000222222000111111
11111100000000000022222222222220000000200000111111
11111100000000000000000000002000000000200000111111
11111100000000000000000000002000300000200040111111
11111122222222222222222222222222222222222222111111
11111111111111111111111111111111111111111111111111
11111111111111111111111111111111111111111111111111
