11111122222222222222222222222222222222222222111111
11111100000000000000000000000000000000000000111111
11111100000000000000000000030000000000000000111111
11111100000000000000000000222220000000000000111111
11111100000000030000000000020000000000000000111111
11111100000002222000000000020000000000222000111111
11111100000000000000000000020000000000000000111111
11111100000000000000000000020000000040030000111111
11111100000002222000000000020000000022222200111111
11111100000000020000400000020003000000000200111111
11111100000000022222222000022222220000000200111111
11111102222000000000000000000000200000000200111111
11111100000000030000000000000000200000400200111111
11111100000002222200000004000000220022222200111111
11111100000000020000000022222200000000000000111111
11111100000000022222222220002000000000000000111111
11111100000000000000000000002000000000000000111111
11111100000000000000000000002000030000040000111111
11111122222222222222222222222222222222222222111111
11111111111111111111111111111111111111111111111111
11111111111111111111111111111111111111111111111111