11111122222222222222222222222222222222222222111111
11111100000000000000000000000000000000000000111111
11111100000000000000000000000000000000000000111111
11111100000000000000000000000000000000000000111111
11111100000000000000000000000000000000000000111111
11111100000000000000000000000000000000000000111111
11111100000000030000000000000000000000000000111111
11111100000002222220000000000000022222220000111111
11111100000000000020000000000000020000000000111111
11111100000000000022222000000222220000000000111111
11111100000000000020000000000000000000000000111111
11111100000000300020000000000000000000000000111111
11111100002222222222000000000000000002220000111111
11111100000000000000000000000000000000020000111111
11111100000000000000000000000000000000020000111111
11111100000222222000000000000000000022222200111111
11111100000200000003000000000000000000000000111111
11111100000200000002222200000222220000000000111111
11111102222200000000000000000002000000000000111111
11111100000000000000000000000002000000300000111111
11111100000000222222000000000002000022222200111111
11111100000000000200000222222002000000000000111111
11111100000000000200000002000002030000000000111111
11111100000000000200000002000002222200000000111111
11111100000000000200000002000000022000000000111111
11111122222222222222222222222222222222222222111111
11111111111111111111111111111111111111111111111111
11111111111111111111111111111111111111111111111111